1111111111111111
100000C000000C01
10C0001111000001
1001111111000001
1000111E00C00001
1111111111111111
