1111111111111111
1000000000000001
1000001111000001
1001111111000001
1P00111E00000011
1111111111111111
